al – бери, возьми
almak – брать, взять
aydın – светлый, чёткий, ясный, интеллигент
çalış – работай, занимайся
çanta – сумка
çay – чай
çok – много, очень
ders – урок
dil – язык
evet – да
getir – принеси
getirmek – приносить
giymek – надеть
gün – день
gün aydın – добрый день, здравствуйте
güzel – красивый, красивая, красивое
hanım — госпожа
hayır – нет
iç – пей
ihtiyar – старик
iyi – хороший, здоровый
kahve – кофе
kısa - короткий 
kim – кто
lira – турецкая лира
merhaba — здравствуйте
nasıl — как, какой
ne - что
okumak – учиться (в учебном заведении)
öğren — учи
öğrenmek – учить, изучать
öğrenci – ученик
öğretmen – учитель
pahalı – дорогой
sıra – очередь, парта, скамейка
teşekkür ederim — спасибо
türk – турок, турчанка
türkçe – турецкий язык
tütün – табак
ucuz — дешёвый
uzun - длинный
uzak - далеко
ve – и
yabancı – иностранец, чужой
yaşlı – пожилой
yemek – есть, кушать
yeni – новый
