şehir - город
okul - школа
tiyatro - театр
sokak - улица
meydan - площадь
ev - дом
kilise - церковь
cami - мечеть
nehir - река
kafe - кафе
otel - гостиница
bahçe - сад
park - парк
banka - банк
durak - остановка
sinema - кинотеатр
yer - место
köprü - мост
kavşağı - круговой перекрёсток
dört yol - перекрёсток
orman - лес
hastane - больница
pazar - рынок
polis - полиция
postane - почта
istasyon - станция, вокзал
merkez - центр
dükkan  - магазин (маленький)
dağ - гора
uçak - самолет
araba - автомобиль
tramvay - трамвай
otobüs - автобус
tren - поезд
bisiklet - велосипед
gemi - корабль