zaman  - время
yıl - год
hafta - неделя
saat - час
dakika - минута
dün - вчера
bugün - сегодня
yarın - завтра
bayram - праздник
sabah - утро
gün - день
gece - ночь
bahar - весна
yaz - лето
sonbahar - осень
kış - зима
Pazartesi - понедельник
Salı - вторник
Çarşamba - среда
Perşembe  - четверг
Cuma - пятница
Cumartesi - суббота
Pazar - воскресенье
Ocak - январь
Şubat  - февраль
Mart - март
Nisan - апрель
Mayıs  - май
Haziran  - июнь
Temmuz - июль
Ağustos - август
Eylül  - сентябрь
Ekim  - октябрь
Kasım - ноябрь
Aralık - декабрь
ay - месяц