anahtar – ключ
ayakkabı – обувь
ayna – зеркало
başka – другой
bina – здание
cep telefonu – сотовый телефон
cevap – ответ
cüzdan – кошелёк, бумажник, кошелёк
çilek – клубника
çorba – суп
domates – помидор
domates çorbası – томатный суп
duvar – стена
elma – яблоко
eşya – вещь
fotoğraf – фотография
gözlük – очки
hangi – какой
kanepe — диван
kapalı – закрытый, закрыто, выключен
kiraz — черешня
kitaplık – этажерка, книжная полка
koltuk — кресло
küçük — маленький
mendil – салфетка, носовой платок, платочек
meyve – фрукт, фрукты
muz - банан
numara – номер, размер
oda — комната
sandalye — стул
sebze – овощ, овощи
sehpa – журнальный столик, маленький столик, подставка
sokak — улица
soru — вопрос
sözlük — словарь
tabii – естественно, конечно, разумеется
tablo – картина; таблица
tamam – одобрение: хорошо, ладно, договорились.
vazo — ваза
yatak – кровать, постель
yer – пол, место, местоположение
yüzük – кольцо, перстень